5,3,7
8,8,3,-300
3
-
01,1 01,1 01,1 01,1 01,1 01,1 00,1 00,1 00,1 00,1 01,1 01,1 01,1 01,1 01,1 01,1 
01,1 01,1 01,1 01,1 01,1 01,1 00,1 00,1 00,1 00,1 01,1 01,1 01,1 01,1 01,1 01,1 
01,1 01,1 01,1 01,1 01,1 01,1 00,1 00,1 00,1 00,1 01,1 01,1 01,1 01,1 01,1 01,1 
01,1 01,1 01,1 01,1 01,1 01,1 00,1 00,1 00,1 00,1 01,1 01,1 01,1 01,1 01,1 01,1 
01,1 01,1 01,1 01,1 01,1 01,1 01,1 01,1 01,1 01,1 01,1 01,1 01,1 01,1 01,1 01,1 
01,1 01,1 01,1 01,1 01,1 01,1 00,1 00,1 00,1 00,1 01,1 01,1 01,1 01,1 01,1 01,1 
01,1 01,1 01,1 01,1 01,1 01,1 00,1 00,1 00,1 00,1 01,1 01,1 01,1 01,1 01,1 01,1 
00,1 01,1 01,1 01,1 01,1 01,1 00,1 00,1 00,1 00,1 01,1 01,1 01,1 01,1 01,1 01,1 
01,1 01,1 01,1 01,1 01,1 01,1 00,1 00,1 00,1 00,1 01,1 01,1 01,1 01,1 01,1 01,1 
-
02,1 02,1 18,1 02,1 02,1 02,1 00,1 00,1 00,1 00,1 02,1 02,1 02,1 02,1 02,1 02,1 
02,1 00,1 00,1 00,1 00,1 02,1 00,1 00,1 00,1 00,1 02,1 00,1 00,1 00,1 00,1 02,1 
02,1 00,1 00,1 00,1 00,1 02,1 00,1 00,1 00,1 00,1 02,1 00,1 00,1 00,1 00,1 02,1 
02,1 00,1 00,1 00,1 00,1 02,1 02,1 02,1 02,1 02,1 02,1 00,1 00,1 00,1 00,1 02,1 
13,1 00,1 00,1 00,1 00,1 00,1 00,1 13,1 00,1 00,1 00,1 00,1 00,1 00,1 00,1 02,1 
02,1 00,1 00,1 00,1 00,1 02,1 02,1 02,1 02,1 02,1 02,1 00,1 00,1 00,1 00,1 14,1 
02,1 00,1 00,1 00,1 00,1 02,1 00,1 00,1 00,1 00,1 02,1 00,1 00,1 00,1 00,1 02,1 
02,1 00,1 00,1 00,1 00,1 02,1 00,1 00,1 00,1 00,1 02,1 00,1 00,1 00,1 00,1 02,1 
02,1 02,1 02,1 02,1 02,1 02,1 00,1 00,1 00,1 00,1 02,1 02,1 02,1 02,1 02,1 02,1 
-
