6,2,2
6,3,-21,-300
1
-
00,1 00,1 00,1 00,1 00,1 00,1 00,1 
00,1 00,1 00,1 00,1 00,1 00,1 00,1 
00,1 00,1 00,1 00,1 00,1 00,1 00,1 
00,1 00,1 00,1 00,1 00,1 01,1 00,1 
00,1 01,1 00,1 00,1 00,1 00,1 00,1 
00,1 01,1 01,1 01,1 01,1 01,1 00,1 
00,1 00,1 00,1 00,1 00,1 00,1 00,1 
-
00,1 00,1 00,1 00,1 00,1 00,1 00,1 
00,1 00,1 00,1 00,1 00,1 00,1 00,1 
00,1 00,1 00,1 00,1 00,1 00,1 00,1 
00,1 00,1 00,1 00,1 01,1 01,1 00,1 
00,1 01,1 00,1 00,1 00,1 00,1 00,1 
00,1 00,1 00,1 00,1 00,1 00,1 00,1 
00,1 00,1 00,1 00,1 00,1 00,1 00,1 
-
00,1 00,1 00,1 00,1 00,1 00,1 00,1 
00,1 00,1 00,1 00,1 00,1 00,1 00,1 
00,1 00,1 00,1 00,1 00,1 00,1 00,1 
00,1 00,1 00,1 00,1 00,1 00,1 00,1 
00,1 00,1 00,1 00,1 01,1 01,1 00,1 
00,1 00,1 00,1 00,1 00,1 00,1 00,1 
00,1 00,1 00,1 00,1 00,1 00,1 00,1 
-
00,1 00,1 00,1 00,1 00,1 00,1 00,1 
00,1 00,1 00,1 00,1 00,1 00,1 00,1 
00,1 00,1 00,1 00,1 00,1 00,1 00,1 
00,1 00,1 00,1 00,1 01,1 01,1 00,1 
00,1 00,1 00,1 00,1 00,1 00,1 00,1 
00,1 00,1 00,1 00,1 00,1 00,1 00,1 
00,1 00,1 00,1 00,1 00,1 00,1 00,1 
-
00,1 00,1 00,1 00,1 00,1 00,1 00,1 
00,1 00,1 00,1 00,1 00,1 00,1 00,1 
00,1 00,1 00,1 00,1 00,1 00,1 00,1 
00,1 00,1 00,1 01,1 01,1 01,1 00,1 
00,1 00,1 00,1 00,1 00,1 00,1 00,1 
00,1 00,1 00,1 00,1 00,1 00,1 00,1 
00,1 00,1 00,1 00,1 00,1 00,1 00,1 
-
00,1 00,1 00,1 00,1 00,1 00,1 00,1 
00,1 00,1 00,1 00,1 00,1 00,1 00,1 
00,1 00,1 00,1 00,1 00,1 01,1 00,1 
00,1 00,1 01,1 01,1 00,1 00,1 00,1 
00,1 00,1 00,1 00,1 00,1 00,1 00,1 
00,1 00,1 00,1 00,1 00,1 00,1 00,1 
00,1 00,1 00,1 00,1 00,1 00,1 00,1 
-
00,1 00,1 00,1 00,1 00,1 00,1 00,1 
00,1 00,1 00,1 00,1 00,1 00,1 00,1 
00,1 00,1 00,1 00,1 00,1 03,1 00,1 
00,1 00,1 01,1 01,1 00,1 00,1 00,1 
00,1 00,1 00,1 00,1 00,1 00,1 00,1 
00,1 00,1 00,1 00,1 00,1 00,1 00,1 
00,1 00,1 00,1 00,1 00,1 00,1 00,1 
-
00,1 00,1 00,1 00,1 00,1 00,1 00,1 
00,1 00,1 00,1 00,1 00,1 00,1 00,1 
00,1 00,1 00,1 00,1 00,1 00,1 00,1 
00,1 00,1 03,1 00,1 00,1 00,1 00,1 
00,1 00,1 00,1 00,1 00,1 00,1 00,1 
00,1 00,1 00,1 00,1 00,1 00,1 00,1 
00,1 00,1 00,1 00,1 00,1 00,1 00,1 
-