6,2,5
12,1,6,-300
1
-
00,1 00,1 00,1 00,1 00,1 00,1 00,1 00,1 00,1 00,1 
00,1 00,1 00,1 00,1 00,1 00,1 00,1 00,1 00,1 00,1 
00,1 00,1 00,1 00,1 00,1 00,1 00,1 00,1 00,1 00,1 
00,1 00,1 00,1 00,1 00,1 00,1 00,1 00,1 00,1 00,1 
00,1 00,1 00,1 00,1 00,1 00,1 00,1 00,1 00,1 00,1 
00,1 00,1 00,1 00,1 00,1 01,1 01,1 00,1 00,1 00,1 
00,1 00,1 00,1 00,1 00,1 00,1 00,1 00,1 00,1 00,1 
-
00,1 00,1 00,1 00,1 00,1 00,1 00,1 00,1 00,1 00,1 
00,1 00,1 00,1 00,1 00,1 00,1 00,1 00,1 00,1 00,1 
00,1 00,1 00,1 00,1 00,1 00,1 00,1 00,1 00,1 00,1 
00,1 00,1 00,1 00,1 00,1 00,1 00,1 00,1 00,1 00,1 
00,1 00,1 01,1 00,1 00,1 01,1 01,1 01,1 00,1 00,1 
00,1 00,1 00,1 00,1 00,1 00,1 00,1 00,1 00,1 00,1 
00,1 00,1 00,1 00,1 00,1 00,1 00,1 00,1 00,1 00,1 
-
00,1 00,1 00,1 00,1 00,1 00,1 00,1 00,1 00,1 00,1 
00,1 00,1 00,1 00,1 00,1 00,1 00,1 00,1 00,1 00,1 
00,1 00,1 00,1 00,1 00,1 00,1 00,1 00,1 00,1 00,1 
00,1 00,1 00,1 00,1 00,1 00,1 00,1 00,1 00,1 00,1 
00,1 00,1 01,1 00,1 00,1 01,1 01,1 01,1 01,1 00,1 
00,1 00,1 00,1 00,1 00,1 00,1 00,1 00,1 00,1 00,1 
00,1 00,1 00,1 00,1 00,1 00,1 00,1 00,1 00,1 00,1 
-
00,1 00,1 00,1 00,1 00,1 00,1 00,1 00,1 00,1 00,1 
00,1 00,1 00,1 00,1 00,1 00,1 00,1 00,1 00,1 00,1 
00,1 00,1 00,1 00,1 00,1 00,1 00,1 00,1 00,1 00,1 
00,1 00,1 00,1 00,1 00,1 00,1 00,1 00,1 00,1 00,1 
00,1 00,1 01,1 00,1 00,1 01,1 00,1 01,1 00,1 00,1 
00,1 00,1 00,1 00,1 00,1 00,1 00,1 00,1 00,1 00,1 
00,1 00,1 00,1 00,1 00,1 00,1 00,1 00,1 00,1 00,1 
-
00,1 00,1 00,1 00,1 00,1 00,1 00,1 00,1 00,1 00,1 
00,1 00,1 00,1 00,1 00,1 00,1 00,1 00,1 00,1 00,1 
00,1 00,1 00,1 00,1 00,1 00,1 00,1 00,1 00,1 00,1 
00,1 00,1 00,1 00,1 00,1 00,1 00,1 00,1 00,1 00,1 
00,1 00,1 00,1 01,1 00,1 00,1 01,1 00,1 00,1 00,1 
00,1 00,1 00,1 00,1 00,1 00,1 00,1 00,1 00,1 00,1 
00,1 00,1 00,1 00,1 00,1 00,1 00,1 00,1 00,1 00,1 
-
00,1 00,1 00,1 00,1 00,1 00,1 00,1 00,1 00,1 00,1 
00,1 00,1 00,1 00,1 00,1 00,1 00,1 00,1 00,1 00,1 
00,1 00,1 00,1 00,1 00,1 00,1 00,1 00,1 00,1 00,1 
00,1 00,1 00,1 00,1 00,1 00,1 01,1 00,1 00,1 00,1 
00,1 00,1 00,1 00,1 01,1 00,1 00,1 00,1 00,1 00,1 
00,1 00,1 00,1 00,1 00,1 00,1 00,1 00,1 00,1 00,1 
00,1 00,1 00,1 00,1 00,1 00,1 00,1 00,1 00,1 00,1 
-
00,1 00,1 00,1 00,1 00,1 00,1 00,1 00,1 00,1 00,1 
00,1 00,1 00,1 00,1 00,1 00,1 00,1 00,1 00,1 00,1 
00,1 00,1 00,1 00,1 00,1 00,1 03,1 00,1 00,1 00,1 
00,1 00,1 00,1 00,1 00,1 00,1 00,1 00,1 00,1 00,1 
00,1 00,1 00,1 01,1 00,1 00,1 00,1 00,1 00,1 00,1 
00,1 00,1 00,1 00,1 00,1 00,1 00,1 00,1 00,1 00,1 
00,1 00,1 00,1 00,1 00,1 00,1 00,1 00,1 00,1 00,1 
-
00,1 00,1 00,1 00,1 00,1 00,1 00,1 00,1 00,1 00,1 
00,1 00,1 00,1 00,1 00,1 00,1 00,1 00,1 00,1 00,1 
00,1 00,1 00,1 00,1 00,1 00,1 00,1 00,1 00,1 00,1 
00,1 00,1 00,1 00,1 00,1 00,1 00,1 00,1 00,1 00,1 
00,1 00,1 03,1 00,1 00,1 00,1 00,1 00,1 00,1 00,1 
00,1 00,1 00,1 00,1 00,1 00,1 00,1 00,1 00,1 00,1 
00,1 00,1 00,1 00,1 00,1 00,1 00,1 00,1 00,1 00,1 
-