24,2,3
28,0,8,-300
1,2,3
-
00,1 00,1 00,1 00,1 00,1 00,1 
00,1 00,1 00,1 00,1 00,1 00,1 
00,1 00,1 00,1 00,1 00,1 00,1 
00,1 00,1 00,1 00,1 00,1 00,1 
00,1 00,1 00,1 00,1 00,1 00,1 
00,1 00,1 00,1 00,1 00,1 00,1 
00,1 00,1 00,1 00,1 00,1 00,1 
00,1 00,1 00,1 00,1 00,1 00,1 
00,1 00,1 00,1 00,1 00,1 00,1 
00,1 00,1 00,1 00,1 00,1 00,1 
00,1 00,1 00,1 00,1 00,1 00,1 
00,1 00,1 00,1 00,1 00,1 00,1 
00,1 00,1 00,1 00,1 00,1 00,1 
00,1 00,1 00,1 00,1 00,1 00,1 
00,1 00,1 00,1 00,1 00,1 00,1 
00,1 00,1 00,1 00,1 00,1 00,1 
00,1 00,1 00,1 00,1 00,1 00,1 
00,1 00,1 00,1 00,1 00,1 00,1 
00,1 00,1 00,1 00,1 00,1 00,1 
00,1 00,1 00,1 00,1 00,1 00,1 
00,1 00,1 00,1 00,1 00,1 00,1 
00,1 00,1 00,1 00,1 00,1 00,1 
00,1 00,1 00,1 00,1 00,1 00,1 
00,1 01,1 01,1 01,1 01,1 00,1 
00,1 00,1 00,1 00,1 00,1 00,1 
-
00,1 00,1 00,1 00,1 00,1 00,1 
00,1 00,1 00,1 00,1 00,1 00,1 
00,1 00,1 00,1 00,1 00,1 00,1 
00,1 00,1 00,1 00,1 00,1 00,1 
00,1 00,1 00,1 00,1 00,1 00,1 
00,1 00,1 00,1 00,1 00,1 00,1 
00,1 00,1 00,1 00,1 00,1 00,1 
00,1 00,1 00,1 00,1 00,1 00,1 
00,1 00,1 00,1 00,1 00,1 00,1 
00,1 00,1 00,1 00,1 00,1 00,1 
00,1 00,1 00,1 00,1 00,1 00,1 
00,1 00,1 00,1 00,1 00,1 00,1 
00,1 00,1 00,1 00,1 00,1 00,1 
00,1 00,1 00,1 00,1 00,1 00,1 
00,1 00,1 00,1 00,1 00,1 00,1 
00,1 00,1 00,1 00,1 00,1 00,1 
00,1 00,1 00,1 00,1 00,1 00,1 
00,1 00,1 00,1 00,1 00,1 00,1 
00,1 00,1 00,1 00,1 00,1 00,1 
00,1 00,1 00,1 00,1 00,1 00,1 
00,1 00,1 00,1 00,1 00,1 00,1 
00,1 00,1 00,1 00,1 00,1 00,1 
00,1 01,1 01,1 02,1 01,1 00,1 
00,1 01,1 00,1 00,1 00,1 00,1
00,1 00,1 00,1 00,1 00,1 00,1 
-
00,1 00,1 00,1 00,1 00,1 00,1 
00,1 00,1 00,1 00,1 00,1 00,1 
00,1 00,1 00,1 00,1 00,1 00,1 
00,1 00,1 00,1 00,1 00,1 00,1 
00,1 00,1 00,1 00,1 00,1 00,1 
00,1 00,1 00,1 00,1 00,1 00,1 
00,1 00,1 00,1 00,1 00,1 00,1 
00,1 00,1 00,1 00,1 00,1 00,1 
00,1 00,1 00,1 00,1 00,1 00,1 
00,1 00,1 00,1 00,1 00,1 00,1 
00,1 00,1 00,1 00,1 00,1 00,1 
00,1 00,1 00,1 00,1 00,1 00,1 
00,1 00,1 00,1 00,1 00,1 00,1 
00,1 00,1 00,1 00,1 00,1 00,1 
00,1 00,1 00,1 00,1 00,1 00,1 
00,1 00,1 00,1 00,1 00,1 00,1 
00,1 00,1 00,1 00,1 00,1 00,1 
00,1 00,1 00,1 00,1 00,1 00,1 
00,1 00,1 00,1 00,1 00,1 00,1 
00,1 00,1 00,1 00,1 00,1 00,1 
00,1 00,1 00,1 00,1 00,1 00,1 
00,1 00,1 00,1 00,1 00,1 00,1 
00,1 01,1 01,1 01,1 01,1 00,1 
00,1 00,1 00,1 00,1 00,1 00,1 
00,1 00,1 00,1 00,1 00,1 00,1 
-
00,1 00,1 00,1 00,1 00,1 00,1 
00,1 00,1 00,1 00,1 00,1 00,1 
00,1 00,1 00,1 00,1 00,1 00,1 
00,1 00,1 00,1 00,1 00,1 00,1 
00,1 00,1 00,1 00,1 00,1 00,1 
00,1 00,1 00,1 00,1 00,1 00,1 
00,1 00,1 00,1 00,1 00,1 00,1 
00,1 00,1 00,1 00,1 00,1 00,1 
00,1 00,1 00,1 00,1 00,1 00,1 
00,1 00,1 00,1 00,1 00,1 00,1 
00,1 00,1 00,1 00,1 00,1 00,1 
00,1 00,1 00,1 00,1 00,1 00,1 
00,1 00,1 00,1 00,1 00,1 00,1 
00,1 00,1 00,1 00,1 00,1 00,1 
00,1 00,1 00,1 00,1 00,1 00,1 
00,1 00,1 00,1 00,1 00,1 00,1 
00,1 00,1 00,1 00,1 00,1 00,1 
00,1 00,1 00,1 00,1 00,1 00,1 
00,1 00,1 00,1 00,1 00,1 00,1 
00,1 00,1 00,1 00,1 00,1 00,1 
00,1 00,1 00,1 00,1 00,1 00,1 
00,1 00,1 00,1 01,1 01,1 00,1 
00,1 00,1 00,1 00,1 00,1 00,1 
00,1 00,1 00,1 00,1 00,1 00,1 
00,1 00,1 00,1 00,1 00,1 00,1 
-
00,1 00,1 00,1 00,1 00,1 00,1 
00,1 00,1 00,1 00,1 00,1 00,1 
00,1 00,1 00,1 00,1 00,1 00,1 
00,1 00,1 00,1 00,1 00,1 00,1 
00,1 00,1 00,1 00,1 00,1 00,1 
00,1 00,1 00,1 00,1 00,1 00,1 
00,1 00,1 00,1 00,1 00,1 00,1 
00,1 00,1 00,1 00,1 00,1 00,1 
00,1 00,1 00,1 00,1 00,1 00,1 
00,1 00,1 00,1 00,1 00,1 00,1 
00,1 00,1 00,1 00,1 00,1 00,1 
00,1 00,1 00,1 00,1 00,1 00,1 
00,1 00,1 00,1 00,1 00,1 00,1 
00,1 00,1 00,1 00,1 00,1 00,1 
00,1 00,1 00,1 00,1 00,1 00,1 
00,1 00,1 00,1 00,1 00,1 00,1 
00,1 00,1 00,1 00,1 00,1 00,1 
00,1 00,1 00,1 00,1 00,1 00,1 
00,1 00,1 00,1 00,1 00,1 00,1 
00,1 00,1 00,1 00,1 00,1 00,1 
00,1 00,1 00,1 00,1 00,1 00,1 
00,1 00,1 01,1 01,1 01,1 00,1
00,1 00,1 00,1 00,1 00,1 00,1 
00,1 00,1 00,1 00,1 00,1 00,1 
00,1 00,1 00,1 00,1 00,1 00,1 
-
00,1 00,1 00,1 00,1 00,1 00,1 
00,1 00,1 00,1 00,1 00,1 00,1 
00,1 00,1 00,1 00,1 00,1 00,1 
00,1 00,1 00,1 00,1 00,1 00,1 
00,1 00,1 00,1 00,1 00,1 00,1 
00,1 00,1 00,1 00,1 00,1 00,1 
00,1 00,1 00,1 00,1 00,1 00,1 
00,1 00,1 00,1 00,1 00,1 00,1 
00,1 00,1 00,1 00,1 00,1 00,1 
00,1 00,1 00,1 00,1 00,1 00,1 
00,1 00,1 00,1 00,1 00,1 00,1 
00,1 00,1 00,1 00,1 00,1 00,1 
00,1 00,1 00,1 00,1 00,1 00,1 
00,1 00,1 00,1 00,1 00,1 00,1 
00,1 00,1 00,1 00,1 00,1 00,1 
00,1 00,1 00,1 00,1 00,1 00,1 
00,1 00,1 00,1 00,1 00,1 00,1 
00,1 00,1 00,1 00,1 00,1 00,1 
00,1 00,1 00,1 00,1 00,1 00,1 
00,1 00,1 00,1 00,1 00,1 00,1 
00,1 00,1 00,1 01,1 01,1 00,1 
00,1 01,1 00,1 00,1 00,1 00,1 
00,1 00,1 00,1 00,1 00,1 00,1 
00,1 00,1 00,1 00,1 00,1 00,1 
00,1 00,1 00,1 00,1 00,1 00,1 
-
00,1 00,1 00,1 00,1 00,1 00,1 
00,1 00,1 00,1 00,1 00,1 00,1 
00,1 00,1 00,1 00,1 00,1 00,1 
00,1 00,1 00,1 00,1 00,1 00,1 
00,1 00,1 00,1 00,1 00,1 00,1 
00,1 00,1 00,1 00,1 00,1 00,1 
00,1 00,1 00,1 00,1 00,1 00,1 
00,1 00,1 00,1 00,1 00,1 00,1 
00,1 00,1 00,1 00,1 00,1 00,1 
00,1 00,1 00,1 00,1 00,1 00,1 
00,1 00,1 00,1 00,1 00,1 00,1 
00,1 00,1 00,1 00,1 00,1 00,1 
00,1 00,1 00,1 00,1 00,1 00,1 
00,1 00,1 00,1 00,1 00,1 00,1 
00,1 00,1 00,1 00,1 00,1 00,1 
00,1 00,1 00,1 00,1 00,1 00,1 
00,1 00,1 00,1 00,1 00,1 00,1 
00,1 00,1 00,1 00,1 00,1 00,1 
00,1 00,1 00,1 00,1 00,1 00,1 
00,1 00,1 00,1 00,1 00,1 00,1 
00,1 00,1 00,1 01,1 01,1 00,1 
00,1 03,1 00,1 00,1 00,1 00,1 
00,1 00,1 00,1 00,1 00,1 00,1 
00,1 00,1 00,1 00,1 00,1 00,1 
00,1 00,1 00,1 00,1 00,1 00,1 
-
00,1 00,1 00,1 00,1 00,1 00,1 00,1 00,1 00,1 00,1 00,1 
00,1 00,1 00,1 00,1 00,1 00,1 00,1 00,1 00,1 00,1 00,1 
00,1 00,1 08,3 08,3 08,3 08,3 08,3 08,3 08,3 08,3 08,3 
00,1 00,1 08,3 01,3 01,3 01,3 01,3 01,3 01,3 01,3 08,3 
00,1 00,1 08,3 01,3 01,3 01,3 01,3 01,3 01,3 01,3 08,3 
00,1 00,1 08,3 01,3 01,3 01,3 01,3 01,3 01,3 01,3 08,3 
00,1 00,1 08,3 01,3 01,3 01,3 01,3 01,3 01,3 01,3 08,3 
00,1 00,1 08,3 01,3 01,3 01,3 01,3 01,3 01,3 01,3 08,3 
00,1 00,1 08,3 01,3 01,3 01,3 01,3 01,3 01,3 01,3 08,3 
00,1 00,1 08,3 01,3 01,3 01,3 01,3 01,3 01,3 01,3 08,3 
00,1 00,1 08,3 08,3 08,3 08,3 02,3 08,3 08,3 08,3 08,3 
00,1 00,1 00,1 00,1 00,1 00,1 01,3 00,1 00,1 00,1 
00,2 00,2 00,2 00,2 00,2 00,2 08,2 08,2 08,2 08,2 
00,2 00,2 00,2 08,2 08,2 08,2 01,2 01,2 01,2 08,2 
00,2 00,2 00,2 08,2 01,2 01,2 01,2 01,2 01,2 08,2 
00,2 00,2 00,2 08,2 01,2 01,2 08,2 01,2 01,2 08,2 
00,2 00,2 00,2 08,2 01,2 01,2 08,2 08,2 08,2 08,2 
00,2 00,2 00,2 08,2 08,2 08,2 00,2 00,2 00,2 00,2 
00,2 00,2 00,2 00,2 08,2 00,2 00,1 00,1 00,1 00,1 
00,2 00,2 00,2 00,2 03,1 00,2 00,1 00,1 00,1 00,1 
00,2 00,2 00,2 00,2 00,2 00,2 00,1 00,1 00,1 00,1 
00,2 00,2 00,2 00,2 00,2 00,2 00,1 00,1 00,1 00,1 
00,2 00,2 00,2 00,2 00,2 00,2 00,1 00,1 00,1 00,1 
00,2 00,2 00,2 00,2 00,2 00,2 00,1 00,1 00,1 00,1 
00,2 00,2 00,2 00,2 00,2 00,2 00,1 00,1 00,1 00,1 
-
00,1 00,1 00,1 00,1 00,1 00,1 00,1 00,1 00,1 00,1 00,1 
00,1 00,1 00,1 00,1 00,1 00,1 00,1 00,1 00,1 00,1 00,1 
00,1 00,1 02,3 02,3 02,3 02,3 18,3 02,3 02,3 02,3 02,3 
00,1 00,1 02,3 00,1 00,1 00,1 00,1 00,1 00,1 00,1 02,3 
00,1 00,1 02,3 00,1 13,3 00,1 00,1 00,1 00,1 00,1 02,3 
00,1 00,1 02,3 00,1 00,1 00,1 00,1 00,1 00,1 00,1 02,3 
00,1 00,1 02,3 00,1 00,1 00,1 02,3 00,1 00,1 00,1 02,3 
00,1 00,1 02,3 00,1 00,1 00,1 00,1 00,1 00,1 00,1 02,3 
00,1 00,1 02,3 00,1 00,1 00,1 00,1 00,1 12,3 00,1 02,3 
00,1 00,1 02,3 00,1 00,1 00,1 00,1 00,1 00,1 00,1 14,3 
00,1 00,1 02,3 02,3 02,3 02,3 00,1 02,3 02,3 02,3 02,3 
00,1 00,1 00,1 00,1 00,1 00,1 00,1 00,1 00,1 00,1 00,1 
00,2 00,2 00,2 00,2 00,2 00,2 11,2 08,2 08,2 08,2 00,1 
00,2 00,2 00,2 08,2 08,2 08,2 00,2 09,2 00,2 08,2 00,1 
00,2 00,2 00,2 08,2 00,2 07,2 00,2 00,2 09,2 08,2 00,1 
00,2 00,2 00,2 08,2 00,2 07,2 08,2 00,2 00,2 08,2 00,1 
00,2 00,2 00,2 08,2 00,2 00,2 08,2 08,2 08,2 08,2 00,1 
00,2 00,2 00,2 08,2 00,2 08,2 00,2 00,2 00,2 00,2 00,1 
-