4,2,8
6,3,6,-300
1,2
-
00,1 00,1 00,1 00,1 00,1 00,1 00,1 00,1 00,1 00,1 00,1 00,1 00,1 00,1 
00,1 00,1 00,1 00,1 00,1 00,1 00,1 00,1 00,1 00,1 00,1 00,1 00,1 00,1 
00,1 00,1 00,1 00,1 00,1 00,1 00,1 00,1 00,1 00,1 00,1 00,1 00,1 00,1 
00,1 00,1 00,1 00,1 00,1 00,1 00,1 00,1 00,1 00,1 00,1 00,1 01,1 00,1 
00,1 00,1 00,1 00,1 00,1 00,1 00,1 00,1 01,1 00,1 00,1 00,1 00,1 00,1 
00,1 00,1 00,1 00,1 00,1 00,1 00,1 00,1 01,1 01,1 01,1 01,1 01,1 00,1 
00,1 00,1 00,1 00,1 00,1 00,1 00,1 00,1 00,1 00,1 00,1 00,1 00,1 00,1 
00,1 00,1 00,1 00,1 00,1 00,1 00,1 00,1 00,1 00,1 00,1 00,1 00,1 00,1 
-
00,1 00,1 00,1 00,1 00,1 00,1 00,1 00,1 00,1 00,1 00,1 00,1 00,1 00,1 
00,1 00,1 00,1 00,1 00,1 00,1 00,1 00,1 00,1 00,1 00,1 00,1 00,1 00,1 
00,1 00,1 00,1 00,1 00,1 00,1 00,1 00,1 00,1 00,1 00,1 00,1 00,1 00,1 
00,1 00,1 00,1 00,1 00,1 00,1 00,1 00,1 00,1 00,1 00,1 01,1 01,1 00,1 
00,1 00,1 00,1 00,1 00,1 00,1 00,1 00,1 01,1 00,1 00,1 00,1 00,1 00,1 
00,1 00,1 00,1 00,1 00,1 00,1 00,1 00,1 00,1 00,1 00,1 00,1 00,1 00,1 
00,1 00,1 00,1 00,1 00,1 00,1 00,1 00,1 00,1 00,1 00,1 00,1 00,1 00,1 
00,1 00,1 00,1 00,1 00,1 00,1 00,1 00,1 00,1 00,1 00,1 00,1 00,1 00,1 
-
00,1 00,1 00,1 00,1 00,1 00,1 00,1 00,1 00,1 00,1 00,1 00,1 00,1 00,1 
00,1 00,1 00,1 00,1 00,1 00,1 00,1 00,1 00,1 00,1 00,1 00,1 00,1 00,1 
00,1 00,1 00,1 00,1 00,1 00,1 00,1 00,1 00,1 00,1 00,1 00,1 00,1 00,1 
00,1 00,1 00,1 00,1 00,1 00,1 00,1 00,1 00,1 00,1 00,1 00,1 00,1 00,1 
00,1 00,1 00,1 00,1 00,1 00,1 00,1 00,1 00,1 00,1 00,1 01,1 01,1 00,1 
00,1 00,1 00,1 00,1 00,1 00,1 00,1 00,1 00,1 00,1 00,1 00,1 00,1 00,1 
00,1 00,1 00,1 00,1 00,1 00,1 00,1 00,1 00,1 00,1 00,1 00,1 00,1 00,1 
00,1 00,1 00,1 00,1 00,1 00,1 00,1 00,1 00,1 00,1 00,1 00,1 00,1 00,1 
-
00,1 00,1 00,1 00,1 00,1 00,1 00,1 00,1 00,1 00,1 00,1 00,1 00,1 00,1 
00,1 00,1 00,1 00,1 00,1 00,1 00,1 00,1 00,1 00,1 00,1 00,1 00,1 00,1 
00,1 00,1 00,1 00,1 00,1 00,1 00,1 00,1 00,1 00,1 00,1 00,1 00,1 00,1 
00,1 00,1 00,1 00,1 00,1 00,1 00,1 00,1 00,1 00,1 00,1 01,1 01,1 00,1 
00,1 00,1 00,1 00,1 00,1 00,1 00,1 00,1 00,1 00,1 00,1 00,1 00,1 00,1 
00,1 00,1 00,1 00,1 00,1 00,1 00,1 00,1 00,1 00,1 00,1 00,1 00,1 00,1 
00,1 00,1 00,1 00,1 00,1 00,1 00,1 00,1 00,1 00,1 00,1 00,1 00,1 00,1 
00,1 00,1 00,1 00,1 00,1 00,1 00,1 00,1 00,1 00,1 00,1 00,1 00,1 00,1 
-
00,1 00,1 00,1 00,1 00,1 00,1 00,1 00,1 00,1 00,1 00,1 00,1 00,1 00,1 
00,1 00,1 00,1 00,1 00,1 00,1 00,1 00,1 00,1 00,1 00,1 00,1 00,1 00,1 
00,1 00,1 00,1 00,1 00,1 00,1 00,1 00,1 00,1 00,1 00,1 00,1 00,1 00,1 
00,1 00,1 00,1 00,1 00,1 00,1 00,1 00,1 00,1 00,1 01,1 01,1 01,1 00,1 
00,1 00,1 00,1 00,1 00,1 00,1 00,1 00,1 00,1 00,1 00,1 00,1 00,1 00,1 
00,1 00,1 00,1 00,1 00,1 00,1 00,1 00,1 00,1 00,1 00,1 00,1 00,1 00,1 
00,1 00,1 00,1 00,1 00,1 00,1 00,1 00,1 00,1 00,1 00,1 00,1 00,1 00,1 
00,1 00,1 00,1 00,1 00,1 00,1 00,1 00,1 00,1 00,1 00,1 00,1 00,1 00,1 
-
00,1 00,1 00,1 00,1 00,1 00,1 00,1 00,1 00,1 00,1 00,1 00,1 00,1 00,1 
00,1 00,1 00,1 00,1 00,1 00,1 00,1 00,1 00,1 00,1 00,1 00,1 00,1 00,1 
00,1 00,1 00,1 00,1 00,1 00,1 00,1 00,1 00,1 00,1 00,1 00,1 01,1 00,1 
00,1 00,1 00,1 00,1 00,1 00,1 00,1 00,1 00,1 01,1 01,1 00,1 00,1 00,1 
00,1 00,1 00,1 00,1 00,1 00,1 00,1 00,1 00,1 00,1 00,1 00,1 00,1 00,1 
00,1 00,1 00,1 00,1 00,1 00,1 00,1 00,1 00,1 00,1 00,1 00,1 00,1 00,1 
00,1 00,1 00,1 00,1 00,1 00,1 00,1 00,1 00,1 00,1 00,1 00,1 00,1 00,1 
00,1 00,1 00,1 00,1 00,1 00,1 00,1 00,1 00,1 00,1 00,1 00,1 00,1 00,1 
-
00,1 00,1 00,1 00,1 00,1 00,1 00,1 00,1 00,1 00,1 00,1 00,1 00,1 00,1 
00,1 00,1 00,1 00,1 00,1 00,1 00,1 00,1 00,1 00,1 00,1 00,1 00,1 00,1 
00,1 00,1 00,1 00,1 00,1 00,1 00,1 00,1 00,1 00,1 00,1 00,1 03,1 00,1 
00,1 00,1 00,1 00,1 00,1 00,1 00,1 00,1 00,1 01,1 01,1 00,1 00,1 00,1 
00,1 00,1 00,1 00,1 00,1 00,1 00,1 00,1 00,1 00,1 00,1 00,1 00,1 00,1 
00,1 00,1 00,1 00,1 00,1 00,1 00,1 00,1 00,1 00,1 00,1 00,1 00,1 00,1 
00,1 00,1 00,1 00,1 00,1 00,1 00,1 00,1 00,1 00,1 00,1 00,1 00,1 00,1 
00,1 00,1 00,1 00,1 00,1 00,1 00,1 00,1 00,1 00,1 00,1 00,1 00,1 00,1 
-
00,1 00,1 00,1 00,1 00,1 00,1 00,1 00,1 00,1 00,1 00,1 00,1 00,1 00,1 
00,1 00,1 00,1 00,1 00,1 00,1 00,1 00,1 00,1 00,1 00,1 00,1 00,1 00,1 
00,1 00,1 00,1 00,1 00,1 00,1 00,1 00,1 00,1 00,1 00,1 00,1 00,1 01,2 
00,1 00,1 00,1 00,1 00,1 00,1 00,1 00,1 00,1 03,1 00,1 00,1 00,1 00,1 
00,1 00,1 00,1 00,1 00,1 00,1 00,1 00,1 00,1 00,1 00,1 00,1 00,1 00,1 
00,1 00,1 00,1 00,1 00,1 00,1 00,1 00,1 00,1 00,1 00,1 00,1 00,1 00,1 
00,1 00,1 00,1 00,1 00,1 00,1 00,1 00,1 00,1 00,1 00,1 00,1 00,1 00,1 
00,1 00,1 00,1 00,1 00,1 00,1 00,1 00,1 00,1 00,1 00,1 00,1 00,1 00,1 
-
00,1 00,1 00,1 00,1 00,1 00,1 00,1 00,1 00,1 00,1 00,1 00,1 00,1 00,1 00,1 01,2 01,2 01,2 00,1 00,1 00,1 00,1 00,1 00,1 00,1 00,1 
00,1 00,1 00,1 00,1 00,1 00,1 00,1 00,1 00,1 00,1 00,1 00,1 00,1 00,1 01,2 01,2 01,2 01,2 01,2 00,1 00,1 00,1 00,1 00,1 00,1 00,1 
00,1 00,1 00,1 00,1 00,1 00,1 00,1 00,1 00,1 00,1 00,1 00,1 00,1 00,1 01,2 01,2 01,2 01,2 01,2 00,1 00,1 00,1 00,1 00,1 00,1 00,1 
00,1 00,1 00,1 00,1 00,1 00,1 00,1 00,1 00,1 00,1 00,1 00,1 00,1 00,1 01,2 01,2 01,2 01,2 01,2 00,1 00,1 00,1 00,1 00,1 00,1 00,1 
00,1 00,1 00,1 00,1 00,1 00,1 00,1 00,1 00,1 00,1 00,1 00,1 00,1 00,1 01,2 01,2 01,2 01,2 01,2 00,1 00,1 00,1 00,1 00,1 00,1 00,1 
00,1 00,1 00,1 00,1 00,1 00,1 00,1 00,1 00,1 00,1 00,1 00,1 00,1 00,1 00,1 00,1 01,2 01,2 01,2 00,1 00,1 00,1 00,1 00,1 00,1 00,1 
-
00,1 00,1 00,1 00,1 00,1 00,1 00,1 00,1 00,1 00,1 00,1 00,1 00,1 00,1 00,1 08,2 08,2 08,2 00,1 00,1 00,1 00,1 00,1 00,1 00,1 00,1 
00,1 00,1 00,1 00,1 00,1 00,1 00,1 00,1 00,1 00,1 00,1 00,1 00,1 00,1 08,2 08,2 09,2 08,2 08,2 00,1 00,1 00,1 00,1 00,1 00,1 00,1 
00,1 00,1 00,1 00,1 00,1 00,1 00,1 00,1 00,1 00,1 00,1 00,1 00,1 00,1 00,2 00,1 07,2 00,1 08,2 00,1 00,1 00,1 00,1 00,1 00,1 00,1 
00,1 00,1 00,1 00,1 00,1 00,1 00,1 00,1 00,1 00,1 00,1 00,1 00,1 00,1 08,2 00,1 07,2 00,1 08,2 00,2 00,1 00,1 00,1 00,1 00,1 00,1 
00,1 00,1 00,1 00,1 00,1 00,1 00,1 00,1 00,1 00,1 00,1 00,1 00,1 00,1 08,2 08,2 08,2 09,2 08,2 00,1 00,1 00,1 00,1 00,1 00,1 00,1 
00,1 00,1 00,1 00,1 00,1 00,1 00,1 00,1 00,1 00,1 00,1 00,1 00,1 00,1 00,1 00,1 08,2 08,2 08,2 00,1 00,1 00,1 00,1 00,1 00,1 00,1 
-